1111111111111111111111111111111111111111111111111
1000000000000001000000000000011000000000011000011
1111011111111011011011111111011011111111011011011
1011000000001011011011000011011011000000011011011
1011011111111011011011011011011011011111111011011
1011011000011000011011011000000011011001000011011
1011111011011011111011111111111111011001011111011
1000011011011000011000011000000011011000011000011
1111011011011111011111011011111011011111011011011
1000011011000011011000011011011011000001011011011
1011111011111011111011111011011011111001011011111
1011000000011000011000000011011000011011011000011
1011111111011111011011111111011111011011111111011
1011000000011011011000000000000001011000000000011
1011011111111011011111111111111111011111111111011
1000001000000000000000000000000000001000000000011
1111111111111111111111111111111111111111111111111

